1111111111111111111111111111111
1.............................0
1........111........1111......0
1.............................0
1.............................0
1...0........000......1.......0
1..0.0.......0.0.......1......0
1...0........000......1.......0
1.............................0
1.............................0
0000000000000000000000000000000